BBBBBBBBBBBBBBB
B0BBBBBBBBBBB0B
B00BB0B0B0BB00B
BB00000000000BB
BBB0B0B0B0B0BBB
BB00000000000BB
BBB0B0B0B0B0BBB
BB00000000000BB
BBB0B0B0B0B0BBB
BB00000000000BB
B00BB0B0B0BB00B
B0BBBBBBBBBBB0B
BBBBBBBBBBBBBBB