BBBBBBBBBBBBBBB
B0000000000000B
B0B0B0B0B0B0B0B
B0000000000000B
B0B0B0B0B0B0B0B
B00000BBB00000B
B0B0B0BBB0B0B0B
B00000BBB00000B
B0B0B0B0B0B0B0B
B0000000000000B
B0B0B0B0B0B0B0B
B0000000000000B
BBBBBBBBBBBBBBB