BBBBBBBBBBBBBBB
B0000000000000B
B0B0B0B0B0B0B0B
B00B0000000B00B
B0B0B0B0B0B0B0B
B000000B000000B
B0B0B0BBB0B0B0B
B000000B000000B
B0B0B0B0B0B0B0B
B00B0000000B00B
B0B0B0B0B0B0B0B
B0000000000000B
BBBBBBBBBBBBBBB